####...###.###.##.##.##..###..##.#.##.#...####..##...#..#..#....#..#..##.##..#.#.####.######.#..#.##..##....#.####.##...#.#..#.####.#.#.#..###.##..#.#.#.#...#.....###.#.#...#..#....#######....#..#...###.##.........#.#.##.#........##...#..##.......####.#.#.#.#.#.####..#..........#.##......##......###.#..##.#.#.....###.#..#...###.##........#..#.##.#.###.#..#####..##..#..#.#.#...###..##..#.###.##...#.##.#.....#.#..........#..##.#########.#.#..##.#.##..######.....####...###..###.#..##########.#.#.....###.##.##.

#.#...#..##..########...##....#.#.###.#.##.##...#..###.#.##.#.#..#..##..###....#..##.##....#...##.#.
.###.#..#.#.#..##.##.#.####..##.#...#.###...#.#....#.#.###..#.#..###...##..######..#..#..#####......
##.#.###.#.#..###...##..###.#.#..#....#...#..#.....##..###.###.######.####.#.#...##.#.##.####..#.##.
...#..##...########.##..#..#...#...#...##.#..#.#..#.##..##.#..#...#.##........#.#.#.######..#..#.#..
.....###....#.##....####..#.#.#.###.###.##.#.#.###..#..##.#...##.###..#.##..##.##..#.#....####..#.#.
..####..###.#..###.#.....#..#..#....#########.####.#..#.##.##..#....#.....#.#.#..#.#..#..###.##...##
###.#..#####...####.##...####...#.#####.##...##.####.###...###...##...#..#.#.######.##....#....##..#
...#...#.#.###..#.#..#.#.####..####.#..#...#...#.#...#...#.....##..#.....#.#.#....#####.##..#.#..###
##...##..###..#..#...#..#..#.####...#.##.###.#.#....#..##....#.....#.##.###.###.#.....#####.#...#...
.##.#..#..#..#.##.#.##.###.###....##.#.#...#####.#..##..#....###..#.#...##.###.#..#.####..##..######
#.#..####.###.#####.###.##....##..####.##.##.#########.........#.#.....####.##.....#.#...##.#....##.
.#..#.#.#..#.#.#.#.#..###....##.#.##.#....#.##.#....#####.#..###...##......#..#.#.##..##..######..##
..##.####.##.....#.#######..##.##...##.####.####.##...####..#.###....#..###..##..#.####....###..##..
#.#....#...#.#.#..#.#..#...#####..#.#..###.#.##...#####.....##.#....#.#.##.#..#.#..###...#.#.#..#..#
##.#.#..#.###.###.##.####....###.#.##.#.#.##...###.##.#.#...##.#.##..#.##.##.#.#....#.....#.#.###...
.#.##.#....#.#.#.###.##..#######.###..#...#...#####.###.#.#.###..###...###.######.#.#....#...#####.#
####..#..####.#......####..##...####...##.#.######.###.###.#.#.#.#....##.#######....##.#..####..##.#
..##.#..###...##....##.###.#.#.#....#..##..###..##..##..#.####..#....#.#.####..#..##.#..#....#..##.#
.#..#.#..##.###....#...####...##.##..#.#..##.##.##.###....##...##.....#.###......###..#.#..###....#.
###.#...#.##...####.#.##.###..#.....##.#.#...#.#..###.##..###.#..#.#.#.#.#####.#.####.##..####..##..
.....#.#..#.##...#..#.....#.###.##########.##.....#..####.##.##.###.##..#.##..#....#.#..##...###.#..
#..#.##.#.#.#..#....##########.###..#.#...#.##...#####..#..##..#..####.......###..#..#.###..###.##.#
###.#..##..##..####...#.####..##.######....#..#...#..##...#####.####.##.####...######..#..##...##..#
..##.#####...#.##..###...###.#......#.#.######.#...####.####.##.##....##..##.#.#..####.#####.######.
..##..#.#..###..#.....####..#.####.##.#.####.##.....####..##..#...###.#...###...#.#.#........##...#.
.#.###.##.##.#.##.##..#.#.###...##..#..#..#.##.#.#..##.#.#.#.##....##....#.#......#....#..#....##.#.
#####.#.###...###.#..#.##.###...###.##.##........#.###.#...##.###.#...###.##.##..#.##.###..####.###.
#....####.#..#.###....##.#.##..##.....#..#...#...##.#..#.#...#..##.#..##..######.##..####.##...#.#..
..#.#..#..##.##...##.###...#...###..#.##..#.#####..#.#.##.#######.##.#.#..##..####.....#####..#.#.##
#.#.....#.#.##.##.##.##......#...##.##.###..#...#.#........##....#.#.....#.##.###....#..###..#..#.##
..#.#.####..#.##...#.###.##....#.##.#########.###...##...##.#.#....#...#...##.....###.##.........#..
###.##.#.#...#...##...##...##.##.#..#.#....##.#.##..#..##.#.##.##..#.#.####.###.#.##.##....#.###.##.
###..#.######.#.###.##.###..##.#..######..###.....###......#.##..##..#.....##..##.##..#.#....##.##.#
..##.#....#.........##.##.#.#..####..##.#......#....#...##.#####..##........##....#.###...###.###..#
##...###.#.#..#.#..##.#.##.####....###....##.#####.##....#.##...##..#.....#....#...######..#.#...###
.##.##.#..###.#.###.#.#.###...####.##.#.#.#.####.#...####.##..###.#...##..##.####..###.#.#..##..##..
#..#...#####.##...#...##..###.#.#....#.#...#########..##.....##.#.#...###......#.##.########..#.##..
##..##.##.......##..##........###.#....#.####.#..#.#.###....#.#.#.#.###.#.#..##..##...##.#.....#....
....#..##...#####...##..#.###....##.##..##.#....#....#..#.#...#.#####...#..##.#.##...#.#...####...##
..##..####.##....#.###.####...###.#.##.##...#..##..#.###.###.#.#.######.#..#####......##..#.###.#.#.
#..#.#....#...###.#.#....##.###..#....##..####.#..#.#####.#.###.######...#..###.##..####.#...##.#..#
..#.##.##.#.##........#..##.....#.#.#.#.##.##..#..##...#.##...#...#.##.###..###.....##..#....#.#..##
###.##...##.#.#...##...####.###.#...####..###...#.##.#..#.#.###......#.#...###..#.####.##.#.#.####..
#.#.##.##...#..##..#....#.##..##......###..###...####..##...###.#.##.##..##...####.#.....#.##.##...#
.....#...#.##.#..#.##.#.####.#######......##.#..#...##..#...#.###.###.#.##.#.##..#.##.##.#..#.###..#
####...#####..##....##.#####...#...#...##.....##..###..#...###..#...#...##.###..###.#####...##.#....
#..###...###....#.#.#.######.###..####..#####...###..###..###....##.#.##..#.##..##..#.###.#####.....
#.#.##.#.####..#####.###.#..#####.#..#.#.#..#.##....##.#.#.#.#.###.###..###...#####.#.##.#.#.#..#...
.#.#...#..#.##.#..####..###.#..#.########.####......#...##..#####..#...#.#..###..#.#....####....#..#
##.###.###..#..##.#..#...#..####..#.###..##....#.#...######.##....##...#....#.........####.#.###.#..
.##..####.##.#.#..####...#.##..##.##..###...#.....##...#......#....##...#####..#####.#.#.#...#..##..
.#...##.#.###.#.#.##....###..###.##.#.##.....###.####.......#.#.#.#....##.#..#..#..#####..#....#.#.#
..#.##.###.###.................###.#...#...#.##.#.###..###..#..##..#.#..###..##.#.##.#.##.##.##.#...
###.#...#..#...###.......###.#.#..#####.####.#..#...##...#####..#........###.#..#.#######..####.#.##
...#.##.#####.#...##.###...##.#..#..##.##.##..#.#.#.#.###...#.##..#.##.##.#.#.##...##.###....#..#.##
##.#.####.##.#..#####.#.#...######.###.#.#.##.##...##.#.##.#..#...##.##.#..#...#..#..#..#..#.##.#...
#.#######.#..#.##..#..#.#..#..####....#.#..#..#...#.....####...#..#.......#..#...##..##.##.##..#.#..
..##.#.####.#.#.#......########..#..#.....###.#.####.#..#####.##..####.#.###....##.#.#..#.##..#####.
.##.#.##.#.#..#.#.#.#...#########...#####..#...###.#.##..##.#..##...###.##.#.#.#.#...####.#.#.####.#
.#####.####..##.##....#.#.#...######.#.#..#.#.#....#.#....##.#..#.###..#..#.####...###..##.#.#.#.#..
.##..#..###.######.#.#.#..######.##..#..#.######....###.##..#####.....####.#.#.#...##.###.#...##.##.
.#.####..##.#..#.#..#.###.##.#....##..#.#..#####.##.##...#..####..###..#........#.##..##.####...###.
..##..###.#.###.#...##.#.##.##.#######..##.#....#.####.#...####...####.###.##.##...##.#..#.#....#..#
.##..#.######..#.#.##.....######.#####......###.#....###.##.#.###.#..#.#.###.#.####...####.##.....##
.####....#.##.##.#.#....#.##.#..#...##.....#..##......#..#######..#.##.###.#..#.###.####..###.#.#..#
..#.##.#.#..##..####....#######.##...#.##.....#.#.##....#.###.#.#..#.###.#.....#.####.#.....##.#...#
##...#.##..##.#.........#..#..#######.##.#..###.#.###..#.##.#..#...#..#..#.##.##.#..###.###...##.##.
...#.#..###..#.##.#####.#.##...#.##..###.#...#...#.##....#####..#####....###..#.####.#...#.###.....#
..#.####..#..#.#..#.######...##.##...##...#.#.#.....#..#...##..#.############.###.####....###..###..
#.#...#.#.##..##..#.#..#...####.##.##.#.#.#.##..##.#.#.....#....#...#...#.###.#.#####..##.###...#..#
.#....#.##..###.#..#.###.#..#.#..##..##.......########.#...#...#####.#...#..#..##.....#.##.....####.
#.#####.#.##.###.#.#....#.#.###...##.#.....##..##..#.#####..#.#.##.#..###..##...#.#.##.#.#.....#.#..
..###...#.#.......#.#......##.#..#.#.#.#.#...#.###.##...####....######......#...#####..###.##...#..#
#..#...#..##..#...#...####.#...#....#####.#...#...#.#.....##...##..#...#....#..#####...#.....##...#.
#.####.#...#...#..##...##....#...#.#.##.##.##...##..##.#..#..#.##.##.##.#.##......#.#...##.....#...#
.#..####..###........#####...#....#.####..##..#####.##.###..#..###...##..##...##.....#..#.#.###.#...
.#....#.####....#....##..#.#.######.#######.#.##.###.###...#.#....##..#..####.###.#....###...#.#....
...###..##.#.##..#.#.#####.######.#..######.##...#.##.#..##.###.#.......#..#...#.###...##..####.##.#
#....###....#..#####.#..#...###..##.##...##.###...#...#....#..#...#..####.#.####...#..##....#...#.##
#.####.###...#..#.####...#..#.##.###.#.##.#....#..##.#.#...##.#..#.##.##..#####..#..#...###...#.####
#.##.##..##.##......#.#.##...###.####.###.####.#...##...#.#...###..###.######.#####....###.####.#...
##..#.###....#.#..###.#..##..###.#..##..#####.#.###..#.#...##.#.#.#.####....##...##....###.#.#.#..##
...#.###.###..###.##...#.###.#.####.##..#.#..###...#..##.######.#.#..###..#.##...##.###....##.#...#.
#..#.#..#.#..#.#.#.#.#..##..#....#..###.###.#...#.#####.#..#..#.#....#.#.#.#....##.##..#...##......#
...#...##....#....#.##.######.#...#.....#.##..#....#..##.#.........###..#..#..#.##.##...#.#..#######
##.##..#..#.#..#.#.######.##...####...#...#..#..##.#......#.#....#.###..#.###...#...#...#.##...###..
#.####.#.##....##..###....#.##.#.##....####.#.#.##.#....#..#..###...#.....##.##....####..###........
..#..##...##.#...#..#.#..###....##...#...####.....####....###..##..##..##.###..#.....######.........
.###.###.##.#...#.##..##.#.##.#.#..#.#..###.#....###.#..##.###....#...#####.###..###.####..#.#...##.
..##.#.#.####.#..#..###.##.#####.#.#....##..#.#.##..##..#...###.#...#...#...#...#..#..##.#...##...##
......###..#####...##..##.#.....###.#...#..###..####..##..#..#####..##..#..##..####.#..#.........#..
###............#.#.......###..#..##..#.#####.#.##.########.##..####.#.########..#.###.....#.####.#.#
.#.....#....##..#.##..#...#.#.##.##..#.##...#.##.#..#......##.....##..##.#..##.###...###....#.##.###
..#...###....##....#.#...###.###..##.##...#.#.#.#..#....###.#.##.....##.#..#.#######.#.###...###....
##.#.#.#.#...####.##..#.#####..######..#.#...#.#.........#....##.....#....#.###....#.#.#..#...##....
.......#.#.#..#....####.##.##.#.......#.#.###..#..#..#..##.#.#.##.#.##.#.#.#..##.#..###..#.###...##.
..##.#.#..##.##...#..#..#..#..###..#.##..#.##..#..#....#....#.##.##.###.##.###..##.......######.###.
##.#.#.#.#.#..###...###..####...##..##.###.#..#..####.#...###..#.##.##.#.#.###..###.#.#.#...###..#..
..##...####......##..#..#..#...#...#..##...######.##......#.#.#....#.#.#.#..#..##.#...#.########...#
####.##.#.#.####..#.#.##.#..#...#.#.##.#....#..#.####.#.#####.###..##.#.####...##.###.#.#....#.#####

